NO ./textures/visual/void_space.png
SO ./textures/visual/void_space.png
WE ./textures/visual/void_space.png
EA ./textures/visual/void_space.png

F 20,20,20
C 200,200,200

11111111111111111111
1N000000000000000001
10111111111111111101
10111111111111111101
10111111111111111101
10111111111111111101
10111111111111111101
10111111111111111101
10111111111111111101
10111111111111111101
10111111111111111101
10000000000000000001
11111111111111111111
